111111111
100000001
100000001
100000001
190000081
100000001
100000001
100000001
111111111
