111111111
100020001
100020001
100020001
190020081
100020001
100020001
100020001
111111111

