111191111
100020001
130232031
102333201
133323331
102333201
130232031
100020001
111181111