111111111
100022001
100020001
100022221
190020081
100022001
100220001
100022001
111111111