111111111
100010001
101010001
101012101
101010101
101010101
101010101
191020081
111111111