111111111
100020001
100110001
100012020
122010201
100011001
122210021
190020081
111111111