111111111
100030001
103030301
103030301
103030301
103030301
103030301
193000381
111111111