111111111
100000001
100000201
100000001
133333331
100010001
102010001
190010081
111111111