111111111
100220001
102230201
103230311
103230311
103200301
103002001
193202181
111111111