111111111
100000001
100030001
100323001
103292301
100323001
100030001
133333331
111181001