111001111
192302001
123020021
103023231
103033031
003330031
003230031
000032201
101180111